0 0 0 0 0 0 0 0 0 0 0 0 0 0 0 0 0 0 0 0 0 0 0 0 0 0 0 0 0 0 0 0 0 0 0 0 0 0 8 9 9 9 9 9 9 9 9 9 9 9 9 9 9 9 9 9 9 9 9 9 9 9 9 9 9 9 9 9 9 9 0 0 0 0 0 0 0 0 0 0 0 0 0 0 0 0 0 0 0
0 0 0 0 0 0 0 0 0 0 0 0 0 0 0 0 0 0 0 0 0 0 0 0 0 0 0 0 0 0 0 0 0 0 0 0 0 0 25 26 26 26 26 26 26 26 26 26 26 26 26 26 26 26 26 26 26 26 26 26 26 26 26 26 26 26 26 26 26 26 0 0 0 0 0 0 0 0 0 0 0 0 0 0 0 0 0 0 0
0 0 0 0 0 0 0 0 0 0 0 0 0 0 0 0 0 0 0 0 0 0 0 0 0 0 0 0 0 0 0 0 0 0 0 0 0 0 25 26 26 26 26 26 26 26 26 26 26 26 26 26 26 26 26 122 123 26 26 26 26 26 26 26 26 26 26 26 26 26 0 0 0 0 0 0 0 0 0 0 0 0 0 0 0 0 0 0 0
0 0 0 0 0 0 0 0 0 0 0 0 0 0 0 0 0 0 0 0 0 0 0 0 0 0 0 0 0 0 0 0 0 0 0 0 0 0 25 26 26 26 26 26 26 26 26 26 26 26 26 26 26 26 122 56 56 123 26 57 26 26 26 26 26 26 26 26 26 26 0 0 0 0 0 0 0 0 0 0 0 0 0 0 0 0 0 0 0
0 0 0 0 0 0 0 0 0 0 0 0 0 0 0 0 0 0 0 0 0 0 0 0 0 0 0 0 0 0 0 0 0 0 0 0 0 0 25 26 26 26 26 26 26 26 26 26 26 26 26 26 26 122 56 56 56 56 75 76 77 26 26 26 26 26 26 26 26 26 0 0 0 0 0 0 0 0 0 0 0 0 0 0 0 0 0 0 0
0 0 0 0 0 0 0 0 0 0 0 0 0 0 0 0 0 0 0 0 0 0 0 0 0 0 0 0 0 0 0 0 0 0 0 0 0 0 25 26 26 26 26 26 26 26 26 26 26 26 26 26 122 56 56 56 56 96 97 98 76 77 26 26 26 26 26 26 26 26 0 0 0 0 0 0 0 0 0 0 0 0 0 0 0 0 0 0 0
0 0 0 0 0 0 0 0 0 0 0 0 0 0 0 0 0 0 0 0 0 0 0 0 0 0 0 0 0 0 0 0 0 0 0 0 0 0 25 26 26 26 26 26 26 26 26 26 26 26 26 120 56 56 56 56 56 109 110 111 112 121 114 26 26 26 26 26 26 26 0 0 0 0 0 0 0 0 0 0 0 0 0 0 0 0 0 0 0
0 0 0 0 0 0 0 0 0 0 0 0 0 0 0 0 0 0 0 0 0 0 0 0 0 0 0 0 0 0 0 0 0 0 0 0 0 0 25 26 26 26 26 26 26 26 26 26 26 26 26 26 124 56 56 56 56 56 109 118 56 56 119 26 26 26 26 26 26 26 0 0 0 0 0 0 0 0 0 0 0 0 0 0 0 0 0 0 0
0 0 0 0 0 0 0 0 0 0 0 0 0 0 0 0 0 0 0 0 0 0 0 0 0 0 0 0 0 0 0 0 0 0 0 0 0 0 25 26 26 26 26 26 26 26 26 26 26 26 26 120 56 56 56 56 56 56 56 56 56 121 26 122 123 26 26 26 26 26 0 0 0 0 0 0 0 0 0 0 0 0 0 0 0 0 0 0 0
0 0 0 0 0 0 0 0 0 0 0 0 0 0 0 0 0 0 0 0 0 0 0 0 0 0 0 0 0 0 0 0 0 0 0 0 0 0 25 26 26 26 26 26 122 123 26 26 26 122 123 26 124 56 56 56 56 56 56 56 56 56 125 56 56 123 26 26 26 26 0 0 0 0 0 0 0 0 0 0 0 0 0 0 0 0 0 0 0
0 0 0 0 0 0 0 0 0 0 0 0 0 0 0 0 0 0 0 0 0 0 0 0 0 0 0 0 0 0 0 0 0 0 0 0 0 0 25 26 26 26 26 122 56 56 123 26 122 56 56 125 56 56 56 56 56 56 56 56 56 56 56 56 56 56 119 26 26 26 0 0 0 0 0 0 0 0 0 0 0 0 0 0 0 0 0 0 0
0 0 0 0 0 0 0 0 0 0 0 0 0 0 0 0 0 0 0 0 0 0 0 0 0 0 0 0 0 0 0 0 0 0 0 0 0 0 25 26 26 26 120 111 126 126 126 125 117 128 128 128 56 128 128 128 76 117 128 128 128 128 56 128 128 129 130 26 26 26 0 0 0 0 0 0 0 0 0 0 0 0 0 0 0 0 0 0 0
0 0 0 0 0 0 0 0 0 0 0 0 0 0 0 0 0 0 0 0 0 0 0 0 0 0 0 0 0 0 0 0 0 0 0 0 0 0 25 26 26 131 26 116 56 56 56 56 56 56 56 56 56 56 56 56 56 56 56 56 56 56 56 56 56 133 134 119 26 26 0 0 0 0 0 0 0 0 0 0 0 0 0 0 0 0 0 0 0
0 0 0 0 0 0 0 0 0 0 0 0 0 0 0 0 0 0 0 0 0 0 0 0 0 0 0 0 0 0 0 0 0 0 0 0 0 0 135 136 136 136 136 137 138 138 138 138 138 138 138 138 138 137 137 137 137 137 137 137 137 137 137 137 137 139 140 136 136 136 0 0 0 0 0 0 0 0 0 0 0 0 0 0 0 0 0 0 0
141 142 142 142 142 142 142 142 142 142 142 142 142 142 142 142 142 142 142 142 142 142 142 142 142 142 142 142 142 142 142 142 142 142 142 142 142 142 142 142 142 142 142 142 142 142 142 142 142 142 142 142 142 142 142 142 142 142 142 142 142 142 142 142 152 153 154 155 142 156 157 157 157 157 157 157 157 157 157 157 159 158 158 158 158 158 158 158 158
176 162 162 162 162 162 162 162 162 162 162 162 162 162 162 162 162 162 162 162 162 162 162 162 162 162 162 162 162 162 162 162 162 162 162 162 162 162 162 162 162 162 162 162 162 162 162 162 162 162 162 162 162 162 162 162 162 162 162 162 162 162 162 162 162 170 171 162 162 172 173 173 173 173 173 173 173 173 173 173 174 173 173 173 173 173 173 173 173
176 162 162 162 162 162 162 162 162 162 162 162 162 162 162 162 162 162 162 162 162 162 162 162 162 162 162 162 162 162 162 162 162 162 162 162 162 162 162 162 162 162 162 162 162 162 162 162 162 162 162 162 162 162 162 162 162 162 162 162 162 162 162 162 162 170 171 162 162 172 173 173 173 173 173 173 173 173 173 173 174 173 173 173 173 173 173 173 173
176 162 162 162 162 162 162 162 162 162 162 162 162 162 162 162 162 162 162 162 162 162 162 162 162 162 162 162 162 162 162 162 162 162 162 162 162 162 162 162 162 162 162 162 162 162 162 162 162 162 162 162 162 162 162 162 162 162 162 162 162 162 162 162 162 184 185 162 162 172 173 173 173 173 173 173 173 173 173 173 174 173 173 173 173 173 173 173 173
176 162 162 162 162 162 162 162 162 162 162 162 162 162 162 162 162 162 162 162 162 162 162 162 162 162 162 162 162 162 162 162 162 162 162 162 162 162 162 162 162 162 162 162 162 162 162 162 162 162 162 162 162 162 162 162 162 162 162 162 162 162 162 162 162 162 162 162 162 172 173 173 173 173 173 173 173 173 173 173 174 173 173 173 173 173 173 173 173
176 162 162 162 162 162 162 162 162 162 162 162 162 162 162 162 162 162 162 162 162 162 162 162 162 162 162 162 162 162 162 162 162 162 162 162 162 162 162 162 162 162 162 162 162 162 162 162 162 162 162 162 162 162 162 162 162 162 162 162 162 162 162 162 162 162 162 162 162 172 173 173 173 173 173 173 173 173 173 173 174 173 187 188 188 188 189 173 173
176 162 162 162 162 162 162 162 162 162 162 162 162 162 162 162 162 162 162 162 162 162 162 162 162 162 162 162 162 162 162 162 162 162 162 162 162 162 162 162 162 162 162 162 162 162 162 162 162 162 162 162 162 162 162 162 162 162 162 162 162 162 162 162 162 162 162 162 162 172 173 173 173 173 173 173 173 173 173 173 174 192 193 194 194 195 196 197 173
176 162 162 162 162 162 162 162 162 162 162 198 199 162 162 162 162 162 162 162 162 198 199 162 162 162 162 162 162 162 162 162 162 162 162 162 162 162 162 162 162 162 162 198 199 162 162 162 162 207 208 209 162 162 162 162 162 162 162 162 212 213 214 162 162 162 198 199 162 172 173 173 173 173 173 173 173 173 173 173 215 216 217 217 217 217 217 218 219
176 162 162 204 205 203 162 162 162 162 162 222 223 162 162 162 162 162 162 162 162 222 223 162 162 162 162 162 162 162 162 162 162 162 162 162 162 162 162 162 162 162 162 222 223 162 162 162 162 228 229 230 162 162 232 233 209 162 234 235 236 237 238 162 162 162 222 223 162 172 173 173 173 239 173 240 241 173 173 173 215 242 217 217 217 217 217 243 219
176 162 162 162 162 162 162 232 233 209 198 246 247 162 162 162 162 162 162 162 198 246 253 254 255 162 255 162 162 162 162 162 162 162 255 198 199 162 255 162 162 162 198 246 247 162 162 162 162 162 162 259 260 261 228 262 263 264 265 266 267 237 238 162 162 198 246 247 162 172 173 173 173 268 269 270 271 173 173 173 272 273 217 217 274 217 275 276 277
176 162 162 162 162 278 279 280 229 230 222 281 282 199 162 162 162 162 162 162 222 281 282 199 162 162 289 290 291 162 289 162 162 162 289 292 293 294 295 199 162 162 222 281 282 199 162 162 296 297 298 299 229 300 162 301 302 303 162 162 304 237 238 162 290 305 281 282 199 172 173 173 173 306 307 173 173 173 309 310 174 311 217 217 312 217 275 313 175
314 315 334 334 315 317 318 319 315 315 320 321 321 322 323 324 315 315 315 315 320 342 342 343 315 315 332 329 330 324 332 315 334 324 332 335 336 337 338 339 340 333 320 321 321 339 340 315 344 345 345 346 316 316 331 315 315 315 334 315 347 348 349 315 329 336 336 336 339 350 351 351 352 353 354 355 351 351 356 357 174 358 359 359 359 359 359 360 175